-------------hh-------------
zuuuuuuuuuuubssbuuuuuuuuuuuz
c222222222222dd222222222222c
1000000000000000000000000001
1000000000000000000000000001
1000000000000000000000000001
1000000000000000000000000001
1000000000000000000000000001
1000000000000000000000000001
1000000000000000000000000001
1000000000000000000000000001
1000000000000000000000000001
1000000000000000000000000001
1000000000000000000000000001
1000000000000000000000000001
1000000000000000000000000001
1000000000000000000000000001
1000000000000000000000000001
1000000000000000000000000001
1000000000000000000000000001
zuuuuuuuuuuuuuuuuuuuuuuuuuuz
2222222222222222222222222222
